to	
drops	
dt	
v/v	
mother liquor	
as	
ml-1	
ligand	
drop	
see reference	
ml	
s	
or	
stock	
divalents	
peptide	
incubated	
mixed	
complex	
x	
a	
compound	
dtsoaking	
"1,2,3-heptanetriol"	"1,2,3-heptanetriol"
"1,2-propanediol"	"1,2-propanediol"
"1,3-propanediol"	"1,3-propanediol"
"1,4-butanediol"	"1,4-butanediol"
"1,4-dioxane"	"1,4-dioxane"
"1,6-hexanediol"	"1,6-hexanediol"
1-butanol	1-butanol
1-propanol	1-propanol
2-hydroxyethyl disulfide	2-hydroxyethyl disulfide
2-mercaptoethanol	2-mercaptoethanol
bme	2-mercaptoethanol
mercaptoethanol	2-mercaptoethanol
"2-methyl-2,4-pentanediol"	"2-methyl-2,4-pentanediol"
"/--2-methyl-2,4-pentanediol"	"2-methyl-2,4-pentanediol"
"2-methyl-2,4-pentanediol mpd"	"2-methyl-2,4-pentanediol mpd"
2-propanol	2-propanol
acetate	acetate
acetic acid	acetic acid
acetone	acetone
acetonitrile	acetonitrile
adp	adp
ams	alpha-methylstyrene
amino acids	amino acids
ammonium acetate	ammonium acetate
nh4 oac	ammonium acetate
nh4 ac	ammonium acetate
nh4 acetate	ammonium acetate
nh4-acetate	ammonium acetate
ammonium chloride	ammonium chloride
nh4 cl	ammonium chloride
ammonium citrate	ammonium citrate
ammonium citrate tribasic	ammonium citrate
ammonium citrate dibasic	ammonium citrate
tri ammonium citrate	ammonium citrate
di ammonium hydrogen citrate	ammonium citrate
ammonium fluoride	ammonium fluoride
nh4 f	ammonium fluoride
ammonium formate	ammonium formate
ammonium iodide	ammonium iodide
ammonium nitrate	ammonium nitrate
nh4 no3	ammonium nitrate
ammonium phosphate	ammonium phosphate
nh4 h2 po4	ammonium phosphate
ammonium dihydrogen phosphate	ammonium phosphate
ammonium phosphate monobasic	ammonium phosphate
nh42 hpo4	ammonium phosphate
ammonium phosphate dibasic	ammonium phosphate
nh42 hpo4/nah2 po4	ammonium phosphate
di ammonium hydrogen phosphate	ammonium phosphate
ammonium sulfate	ammonium sulfate
ammonium sulphate	ammonium sulfate
nh42 so4	ammonium sulfate
amso4	ammonium sulfate
nh4 so4	ammonium sulfate
ammoniumsulfate	ammonium sulfate
ammonium tartrate dibasic	ammonium tartrate
ammonium tartrate	ammonium tartrate
di ammonium tartrate	ammonium tartrate
amp	amp
amppnp	amp pnp
amp pnp	amp pnp
arginine hcl	arginine
atp	atp
coh18 n6	azane cobalt
azide	azide
ada	azodicarbonamide
bacl2	barium chloride
barium chloride	barium chloride
benzamidine	benzamidine
benzamidine hcl	benzamidine
bes	beryllium sulfide
beta mercaptoethanol	beta mercaptoethanol
bicine	bicine
bicine naoh	bicine
bicine/trizma base	bicine trizma
bis tris	bis tris
bistris	bis tris
bis tris hcl	bis tris
bis tris:hcl	bis tris
bis/tris	bis tris
bis tris or	bis tris
mes bis tris	bis tris mes
bis tris methane	bis tris methane
bis tris methane hcl	bis tris methane
bis tris propane	bis tris propane
btp	bis tris propane
bistris propane	bis tris propane
bistrispropane	bis tris propane
bicine csoh	biscene cesium hydroxide
bog	bog
btprop	btprop
cacodylate	cacodylate
cacodylic acid	cacodylic acid
cdcl2	cadmium chloride
cadmium chloride	cadmium chloride
cadmium sulfate	cadmium sulfate
cdso4	cadmium sulfate
cscl	caesium chloride
calcium acetate	calcium acetate
ca acetate	calcium acetate
caoac2	calcium acetate
calcium acetate hydrate	calcium acetate
caac2	calcium acetate
caacetate	calcium acetate
cacl2	calcium chloride
calcium chloride	calcium chloride
calcium chloride dihydrate	calcium chloride
cacl	calcium chloride
caps	caps
capso	capso
carboxylic acids	carboxylic acids
cdk2	cdk2
cesium chloride	cesium chloride
chaps	chaps
ches	ches
citrate	citrate
citric acid	citric acid
cocl2	cobalt chloride
cobalt chloride	cobalt chloride
cobalt hexamine	cobalt hexamine
coa	coenzyme a
cucl2	copper chloride
cuso4	copper sulfate
cryo	cryo
cymal-6	cymal-6
d galactose	d galactose
d glucose	d glucose
diethylene glycol	diethylene glycol
dmso	dimethyl sulfoxide
dimethyl sulfoxide	dimethyl sulfoxide
dioxane	dioxane
dithiothreitol	dithiothreitol
dl alanine	dl alanine
dl malic acid	dl malic acid
dl serine	dl serine
dna	dna
ldao	dodecyldimethylamine oxide
dtt	dtt
dtt set up	dtt
dtt crystallization	dtt
egta	egtazic acid
ethanol	ethanol
etoh	ethanol
ethylene glycol	ethylene glycol
eg	ethylene glycol
ethyleneglycol	ethylene glycol
edta	ethylenediaminetetraacetic acid
etgly	ethylglycene
fad	fad
gdp	gdp
glucose	glucose
gsh	glutathione
glutathion	glutathione
glycerol	glycerol
glycero	glycerol
glycerol v/v	glycerol
glycerol ethoxylate	glycerol ethoxylate
glycine	glycine
gtp	gtp
guanidine hcl	guanidine
guanidine hydrochloride	guanidine
hepes	hepes
na hepes	hepes
hepes naoh	hepes
hepes na	hepes
hepes sodium	hepes
hepes/naoh	hepes
sodium hepes	hepes
nahepes	hepes
hepes:naoh	hepes
hepes koh	hepes
hepes sodium salt	hepes
hepes 7.5	hepes
hepes hcl	hepes
hepes/mops	hepes mops
mops/hepes na	hepes mops
hepps	hepps
hexaamminecobalt iii chloride	hexaamminecobalt iii chloride
hexanediol	hexanediol
hcl	hydrochloric acid
imidazole	imidazole
imidazole hcl	imidazole
imidazole malate	imidazole malate
inhibitor	inhibitor
isopropanol	isopropanol
iso propanol	isopropanol
jeffamine	jeffamine
jeffamine ed-2001	jeffamine ed-2001
jeffamine m600	jeffamine m600
jeffamine m-600	jeffamine m600
l arginine	l arginine
l cysteine	l cysteine
l proline	l proline
l tyrosine	l tyrosine
lactose	lactose
lithium acetate	lithium acetate
licl	lithium chloride
lithium chloride	lithium chloride
licl2	lithium chloride
lithium citrate	lithium citrate
tri lithium citrate	lithium citrate
lithium nitrate	lithium nitrate
lino3	lithium nitrate
lithium sulfate	lithium sulfate
li2 so4	lithium sulfate
liso4	lithium sulfate
lithium sulphate	lithium sulfate
lithium sulfate monohydrate	lithium sulfate
li sulfate	lithium sulfate
magnesium acetate	magnesium acetate
mgac2	magnesium acetate
magnesium acetate tetrahydrate	magnesium acetate
mgoac2	magnesium acetate
mgacetate	magnesium acetate
mgac	magnesium acetate
mgcl2	magnesium chloride
magnesium chloride	magnesium chloride
magnesium chloride hexahydrate	magnesium chloride
mgcl	magnesium chloride
mgcl2.6 h2 o	magnesium chloride
magnesium formate	magnesium formate
magnesium formate dihydrate	magnesium formate
magnesium nitrate	magnesium nitrate
mgno32	magnesium nitrate
mgso4	magnesium sulfate
magnesium sulfate	magnesium sulfate
magnesium sulphate	magnesium sulfate
malic acid	malic acid
malonate	malonate
malonic acid	malonic acid
maltose	maltose
mncl2	manganese chloride
manganese chloride	manganese chloride
mnso4	manganese sulfate
mega	mega
mepeg2000	mepeg2000
mepeg5000	mepeg5000
mes	mes
mes naoh	mes
mes monohydrate	mes
mes/naoh	mes
na mes	mes
sodium mes	mes
mes:naoh	mes
2-n morpholinoethanesulfonic acid	mes
mes/imidazole	mes imidazole
methanol	methanol
mib	mib
mmt	mmt
mops	mops
mopso	mopso
morpheus	morpheus
mpd	mpd
mpeg2000	mpeg2000
mpeg5000	mpeg5000
n octyl beta d glucoside	n octyl beta d glucoside
nac	n-acetylcysteine
nad	nad
nadh	nadh
nadp	nadp
nadph	nadph
nicl2	nickel chloride
nickel chloride	nickel chloride
nps	nitrate phosphate sulfate
oxonate	oxonate
pctp	pctp
peg	peg
peg mme2000	peg mme2000
peg mme350	peg mme3350
peg mme500	peg mme500
peg mme5000	peg mme5000
peg mme550	peg mme550
peg mme750	peg mme750
peg smear broad	peg smear broad
peg smear high	peg smear high
peg1000	peg1000
peg10000	peg10000
peg1450	peg1450
peg1500	peg1500
peg20	peg20
peg200	peg200
peg2000	peg2000
peg20000	peg20000
peg300	peg300
peg3000	peg3000
peg3350	peg3350
peg3350 no	peg3350
peg3350 cryoprotection	peg3350
peg3550	peg3350
poly ethylene glycol3350	peg3350
wt/vol peg3350	peg3350
peg3400	peg3400
peg3500	peg3500
peg400	peg400
peg400 v/v	peg400
peg4000	peg4000
peg5000	peg5000
peg550	peg550
peg600	peg600
peg6000	peg6000
peg8000	peg8000
pentaerythritol ethoxylate	pentaerythritol ethoxylate
pentaerythritol ethoxylate 15/4-eooh	pentaerythritol ethoxylate
pentaerythritol propoxylate	pentaerythritol propoxylate
pentaerythritol propoxylate 5/4-pooh	pentaerythritol propoxylate
pentaerythritol propoxylate po/oh 5/4	pentaerythritol propoxylate
pga lm	pga lm
phenol	phenol
pmsf	phenylmethylsulfonyl fluoride
phosphate	phosphate
citrate phosphate	phosphate citrate
phosphate citrate	phosphate citrate
phosphate/citrate	phosphate citrate
pipes	pipes
polyacrylic acid	polyacrylic acid
pcb	polychlorinated biphenyl
potassium acetate	potassium acetate
kbr	potassium bromide
potassium bromide	potassium bromide
kcl	potassium chloride
potassium chloride	potassium chloride
potassium citrate	potassium citrate
tri potassium citrate	potassium citrate
potassium fluoride	potassium fluoride
kf	potassium fluoride
potassium formate	potassium formate
ki	potassium iodide
potassium iodide	potassium iodide
potassium nitrate	potassium nitrate
kno3	potassium nitrate
potassium phosphate	potassium phosphate
kh2 po4	potassium phosphate
k2 hpo4	potassium phosphate
potassium phosphate dibasic	potassium phosphate
potassium phosphate monobasic	potassium phosphate
potassium dihydrogen phosphate	potassium phosphate
k phosphate	potassium phosphate
kpi	potassium phosphate
kpo4	potassium phosphate
potassium phosphate calcium chloride pdtp	potassium phosphate calcium chloride pdtp
potassium sulfate	potassium sulfate
kscn	potassium thiocyanate
potassium thiocyanate	potassium thiocyanate
proline	proline
propan-2-ol	propan-2-ol
propanol	propanol
pvp k15	pvp k15
plp	pyridoxal phosphate
sam	s-adenosyl methionine
sah	s-adenosyl-l-homocysteine
sds	sds
sodium acetate	sodium acetate
na acetate	sodium acetate
sodium acetate trihydrate	sodium acetate
naoac	sodium acetate
naac	sodium acetate
naacetate	sodium acetate
ch3 coona	sodium acetate
sodium acetate/acetic acid	sodium acetate
nan3	sodium azide
sodium azide	sodium azide
sodium bicine	sodium bicine
nabr	sodium bromide
sodium bromide	sodium bromide
sodium cacodylate	sodium cacodylate
na cacodylate	sodium cacodylate
sodium cacodylate trihydrate	sodium cacodylate
nacacodylate	sodium cacodylate
nacl	sodium chloride
sodium chloride	sodium chloride
sodium citrate	sodium citrate
na citrate	sodium citrate
tri sodium citrate	sodium citrate
sodium citrate tribasic dihydrate	sodium citrate
trisodium citrate	sodium citrate
nacitrate	sodium citrate
sodium citrate tribasic	sodium citrate
tri sodium citrate dihydrate	sodium citrate
sodium citrate tribasic dehydrate	sodium citrate
na3 citrate	sodium citrate
sodium citrate/citric acid	sodium citrate
tri na citrate	sodium citrate
sodium succinate	sodium cuccinate
sodium dithionite	sodium dithionite
sodium edta	sodium edetate
naf	sodium fluoride
sodium fluoride	sodium fluoride
sodium formate	sodium formate
na formate	sodium formate
naformate	sodium formate
nai	sodium iodide
sodium iodide	sodium iodide
sodium malonate	sodium malonate
na malonate	sodium malonate
sodium nitrate	sodium nitrate
nano3	sodium nitrate
sodium oxamate	sodium oxamate
sodium phosphate	sodium phosphate
nah2 po4	sodium phosphate
sodium phosphate monobasic	sodium phosphate
na2 hpo4	sodium phosphate
sodium dihydrogen phosphate	sodium phosphate
dibasic sodium phosphate	sodium phosphate
sodium phosphate monobasic monohydrate	sodium phosphate
sodium phosphate dibasic	sodium phosphate
napi	sodium phosphate
na phosphate	sodium phosphate
na/k phosphate	sodium potassium phosphate
sodium/potassium phosphate	sodium potassium phosphate
sodium potassium phosphate	sodium potassium phosphate
na k phosphate	sodium potassium phosphate
nak phosphate	sodium potassium phosphate
potassium sodium tartrate	sodium potassium tartrate
potassium sodium tartrate tetrahydrate	sodium potassium tartrate
na/k tartrate	sodium potassium tartrate
k/na tartrate	sodium potassium tartrate
sodium potassium tartrate	sodium potassium tartrate
sodium/potassium tartrate	sodium potassium tartrate
potassium/sodium tartrate	sodium potassium tartrate
na k tartrate	sodium potassium tartrate
k na tartrate	sodium potassium tartrate
nak tartrate	sodium potassium tartrate
sodium sulfate	sodium sulfate
na2 so4	sodium sulfate
sodium sulphate	sodium sulfate
sodium tartrate	sodium tartrate
na tartrate	sodium tartrate
sodium thiocyanate	sodium thiocyanate
nascn	sodium thiocyanate
spermidine	spermidine
spermine	spermine
spermine tetrahydrochloride	spermine tetrahydrochloride
spermine hcl	spermine tetrahydrochloride
spermine tetra hcl	spermine tetrahydrochloride
spg	spg
srcl2	strontium chloride
strontium chloride	strontium chloride
succinate	succinate
succinic acid	succinic acid
sucrose	sucrose
tacsimate	tacsimate
tascimate	tacsimate
taps	taps
taurine	taurine
tcep	tcep
tcep hcl	tcep
tert butanol	tert butanol
t butanol	tert butanol
trehalose	trehalose
tricl	trichloride
trimethylamine n oxide	trimethylamine n oxide
tmao	trimethylamine n oxide
trimethylamine n oxide dihydrate	trimethylamine n oxide
tris	tris
tris hcl	tris
tris/hcl	tris
tris cl	tris
trishcl	tris
tris hydrochloride	tris
tris:hcl	tris
tris base	tris
triscl	tris
tris acetate	tris acetate
tris/bicine	tris bicine
tris bicine	tris bicine
tryptone	tryptone
urea	urea
xylitol	xylitol
ybcl3	ytterbium chloride
zinc acetate	zinc acetate
zn acetate	zinc acetate
zncl2	zinc chloride
zinc chloride	zinc chloride
znso4	zinc sulfate
zinc sulfate	zinc sulfate
zinc sulphate	zinc sulfate
names	
